[console_scripts]
akamai-cert-status-check-and-update = poppy.cmd.akamai_check_and_update_cert_status:run
akamai-property-udpate-mod-san = poppy.cmd.akamai_update_papi_property_for_mod_san:run
poppy-server = poppy.cmd.server:run
poppy-worker = poppy.cmd.task_flow_worker:run

[poppy.distributed_task]
taskflow = poppy.distributed_task.taskflow:Driver

[poppy.dns]
default = poppy.dns.default:Driver
designate = poppy.dns.designate:Driver
rackspace = poppy.dns.rackspace:Driver

[poppy.manager]
default = poppy.manager.default:Driver

[poppy.metrics]
blueflood = poppy.metrics.blueflood:Driver

[poppy.notification]
mailgun = poppy.notification.mailgun:Driver

[poppy.provider]
akamai = poppy.provider.akamai:Driver
cloudfront = poppy.provider.cloudfront:Driver
fastly = poppy.provider.fastly:Driver
maxcdn = poppy.provider.maxcdn:Driver
mock = poppy.provider.mock:Driver

[poppy.provider.akamai.cert_info_storage]
cassandra = poppy.provider.akamai.cert_info_storage.cassandra_storage:CassandraSanInfoStorage
zookeeper = poppy.provider.akamai.cert_info_storage.zookeeper_storage:ZookeeperSanInfoStorage

[poppy.storage]
cassandra = poppy.storage.cassandra:Driver
mockdb = poppy.storage.mockdb:Driver

[poppy.transport]
pecan = poppy.transport.pecan:Driver

