[bob.bio.algorithm]
gmm-banca = bob.bio.spear.config.algorithm.gmm_regular_banca:algorithm
gmm-timit = bob.bio.spear.config.algorithm.gmm_timit:algorithm
gmm-voxforge = bob.bio.spear.config.algorithm.gmm_voxforge:algorithm
isv-mobio = bob.bio.spear.config.algorithm.isv_mobio:algorithm
isv-voxforge = bob.bio.spear.config.algorithm.isv_voxforge:algorithm
ivec-cosine-voxforge = bob.bio.spear.config.algorithm.ivec_cosine_voxforge:algorithm
ivec-plda-mobio = bob.bio.spear.config.algorithm.ivec_plda_mobio:algorithm
ivec-plda-voxforge = bob.bio.spear.config.algorithm.ivec_plda_voxforge:algorithm
jfa-voxforge = bob.bio.spear.config.algorithm.jfa_voxforge:algorithm

[bob.bio.database]
asvspoof-licit = bob.bio.spear.config.database.asvspoof:database_licit
asvspoof-spoof = bob.bio.spear.config.database.asvspoof:database_spoof
avspoof-licit = bob.bio.spear.config.database.avspoof:database_licit
avspoof-spoof = bob.bio.spear.config.database.avspoof:database_spoof
banca-audio = bob.bio.spear.config.database.banca_audio_G:database
mobio-audio-female = bob.bio.spear.config.database.mobio_audio_female:database
mobio-audio-male = bob.bio.spear.config.database.mobio_audio_male:database
timit = bob.bio.spear.config.database.timit:database
voxforge = bob.bio.spear.config.database.voxforge:database

[bob.bio.extractor]
htk = bob.bio.spear.config.extractor.htk:extractor
lfcc-60 = bob.bio.spear.config.extractor.lfcc_60:extractor
mfcc-60 = bob.bio.spear.config.extractor.mfcc_60:extractor
spro = bob.bio.spear.config.extractor.spro:extractor

[bob.bio.grid]
demanding = bob.bio.spear.config.grid.demanding:grid

[bob.bio.preprocessor]
energy-2gauss = bob.bio.spear.config.preprocessor.energy_2gauss:preprocessor
energy-thr = bob.bio.spear.config.preprocessor.energy_thr:preprocessor
external = bob.bio.spear.config.preprocessor.external:preprocessor
mod-4hz = bob.bio.spear.config.preprocessor.mod_4hz:preprocessor

